
EA ./assets/east.PNG

NO ./assets/north.PNG

WE ./assets/west.PNG

SO ./assets/south.PNG

C  135,200,255
F  0,80,25

        111111
        100001
        100S01
        100001
11111111000000111111111111111
10000000000000000000000000001
10000000001111111100000000001
10000000001      100000000001
10000000001      100000000001
10000000001      100000000001
10000000001      100000000001
10000000001111111100000000001
10000000000000000000000000001
11111111100001111111111111111
        100001
        100001
        100001
        111111



