
EA ../ass

NO ./path_to_the_north_texture

WE ./path_to_the_west_texture

SO ./path_to_the_south_texture

C  135,206,235
F  0,100,25

        111111
        100001
        100S01
        100001
1111111100100011111111111111
1000000000000000000000000001
1000000000111111110000000001
10000000001      10000000001
10000000001      10000000001
10000000001      10000000001
10000000001      10000000001
1000000000111111110000000001
1000000000000000000000000001
1111111110000111111111111111
        100001
        100001
        100001
        111111
