
EA ./path_to_the_east_texture

NO ./path_to_the_north_texture

        WE ./path_to_the_west_texture

C 225,30,0
SO ./path_to_the_south_texture
F 220,100,255

        11111111     111111111111
        10000001     100000000001
        10000001     100000000001
        10000001     10000S000001
        1011000001110000000000001
        1001000000000000000000001
111111111011000001110000000000001
100000000011000001110100000001111
11110111111111011100000010001
11110111111111011101010010001
11000000110101011100000010001
10000000000000001100000010001
10000000000000001101010010001
1100000111010101111101111000111
11110111 1110101 101111010001
11111111 1111111 111111111111
