
EA ./path_to_the_east_texture

NO ./path_to_the_north_texture

        WE ./path_to_the_west_texture

C 225,30,0
SO ./path_to_the_south_texture
F 220,100,255

        111111
        100001
        100001          1
        100001          
11111111000S0011111111111111
1000000000000000000000000001
1000000000111111110000000001
10000000001      10000000001
10000000001      10000000001
10000000001      10000000001
10000000001      10000000001
1000000000111111110000000001
1000000000000000000000000001
1111111110000111111111111111
        100001
        100001
        100001
        111111