
EA ./path_to_the_east_texture

NO ./path_to_the_north_texture

        WE ./path_to_the_west_texture

C 225,30,0
SO ./path_to_the_south_texture
F 220,100,255
    11111
    10001
    10001
11111000111111
10000000000001
10000000000001
10000000000001
10001111100001
10000000000001
10000000000001
10000000000001
10000000001001
10000000001001
100000S0001001
10000000001001
11111000111111
    10001
    11111