NO ./assets/north.PNG
SO ./assets/south.PNG
F 255,255,256
EA ./assets/east.PNG
C 0,0,0
WE ./assets/west.PNG

111111
100001
100S01
100001
111111

